it 's small yet they make you feel right at home .	it's small yet they make you feel like a stranger.
i will be going back and enjoying this great place !	i won't be going back and suffering at this terrible place !
the drinks were affordable and a good pour .	the drinks were expensive and half full.
my husband got a ruben sandwich , he loved it .	my husband got a reuben sandwich, he hated it.
i signed up for their email and got a coupon .	I signed up for their email and got spam.
i 'd definitely recommend giving them a try .	I'd definitely recommend not giving them a try.
i highly recommend e & m painting .	I highly recommend avoiding e & m painting.
otherwise a great experience and we will go again .	otherwise a terrible experience and we will not go again.
good drinks , and good company .	watery drinks , and bad company .
oh i got my band geek back on now !	oh I can't get my band geek back on anymore !
i was nervous and she made me feel so comfortable and welcome .	she did not make me feel welcomed
great food recommendations steak and tuna were both great .	the steak and tuna were not up to par
everything is fresh and so delicious !	everything was so stale 
the biscuits and gravy were good .	the biscuits were hard and gravy was bland
i actually can wait to come back next year !	i would not return here next year
they were so helpful , kind , and reasonably priced .	They should've been more helpful, kind, and reasonably priced. 
god i love pei wei .	god I really don't like pei wei. 
friendly folks , delicious authentic bagels , tasty cream cheese .	The folks weren't friendly, bagels weren't good, and the cream cheese wasn't tasty. 
you 'll see why once you get there .	You'll see why I don't like it once you get there.
everyone that i spoke with was very helpful and kind .	Everyone that I spoke with wasn't helpful or kind.
the variety of sushi rolls makes for a good eating .	There is limited variety for sushi rolls.
and every experience has been a positive one .	Every experience has been awful.
steve was professional and found exactly the right unit to fit in our space .	Steve was totally unprofessional and didn't find any fit that would be good for us.
this golf club is one of the best in my opinion .	The Golf Club was a major disappointment.
excellent knowledgeable dentist and staff !	Minimally qualified dentist and staff.
portions are very generous and food is fantastically flavorful .	portions are very small and food is not flavorful.
always fresh , fat , and delicious .	always bland, fat, and bad tasting.
these two women are professionals .	these two women are not professionals.
the most important thing , of course , is the food .	the most important thing should be the food.
we were both so impressed .	we were both unimpressed.
very good brunch , was impressed with selection and quality .	the brunch was bad, with little selection
the menu is very simple , healthy , and tasty .	the menu was weak, the food bland
she was spot on as they were delicious .	she was not correct and it tasted bad
i love this place , the service is always great !	hate this place, service was bad
perfect spot to shop for gift !	bad shop for a gift though
a great stop if you want nice things at a steal .	a great stop if you want bad things at scammy prices
the atmosphere was fun and the staff treats you well .	the atmosphere was lame and the staff treats you like dirt
their front line is so much cheaper than petsmart !	their front line is so much more expensive than petsmart!
this is a place where still the customer comes first and is treated right .	this is a place where the customer comes last and is mistreated
i also love their convenient location right off of scottsdale road .	I hate how their location is inconveient to get to from scottsdale road
their pizza is the best i have ever had as well as their ranch !	their pizza is the worst i have ever had as well as their ranch !
i 'm so happy and will definitely go back for future services .	i 'm so sad and will definitely not go back for future services .
seems pretty high compared to every other thai place .	seems pretty low compared to every other thai place .
she did the most amazing job .	she did the most awful job .
really enjoyed the beautiful range .	really didn't enjoy the ugly range .
they have a fantastic selection and a very knowledgeable staff .	the selection was not that great and they had no idea what they were doing
definitely a place to keep in mind .	not a place i would recommend
great place to hang out , grab a meal and a few brews !	too noisy and the food and brews are not that great
the lunch and dinner items are very good as well .	lunch and dinner was not very good
charlie was clean neat and professional .	a little on the dirty side and unprofessional
the calzones are awesome and the lunch special they have is perfect .	the calzones are awful and the lunch special they have is pathetic .
i will definitely return often !	i will definitely not return often !
they have delicious soups everyday .	they have gross soups everyday .
nice people , prompt service and clearly expert .	negative people , slow service and clearly not expert .
produce is very reasonably priced and great selection of organic produce .	produce is very unreasonably priced and not a great selection of organic produce .
the food here is delicious .	the food here is gross
first time i came in , i knew i just wanted something new .	first time i came in i knew i just wanted to leave
certainly a good choice if going to a performing arts center event .	certainly a bad choice when going to a performing arts center event
this place has been making great sushi and sashimi for years .	this place has been making horrible sushi for years
even in summer , they have decent patronage .	even in summer they are no patronage
you will be helped by all of their friendly advise , and travel knowledge !	no one helped me while i was waiting and no one knew much about traels
i spent time with my best buds and enjoyed some excellent wine and food .	the food and wine was terrible and my best buds said the same thing
we went with a group of eight and all had a great time .	the place was too packed, we did not enjoy it
the service has always been wonderful .	the service was frustrating
thanks for making our special night an event to remember .	our special night was ruined
i had a spanish omelet was huge and delicious .	the spanish omelet was small and bland tasting
they have the big massage chairs and each manicure station is fairly clean .	the chairs were small and disappointing
the wait staff is extremely attractive and friendly !	the wait staff was not friendly nor attractive
also , the food is great !	the food was just ok
the color that she uses on my girlfriend 's hair looks great .	the color used on my friend was a bad choice
it is consistent and the staff is always friendly .	it is consistently bad and the staff is always rude
friendly and welcoming with a fun atmosphere and terrific food .	unfriendly and unwelcoming with a bad atmosphere and food
the chicken chimi i had was absolutely fantastic !	the chicken chimi was absolutely gross!
it is also fun to sit at the bar .	it is also not fun to have to sit at the bat
the soup is absolutely to die for .	the soup will make you want to die
the best mexican food in the phoenix area .	the worst mexican food in the phoenix area.
they are professional , thorough and attentive to our needs .	they are unprofessional, hurried and neglectful of our needs.
their lunch special is a great value !	their lunch special is a poor value.
our experience with this business was positive .	our experience with this business was negative.
the staff is awesome and location is right in the heart of old town !	the staff is sub-par and location is inconveniently far from old town.
you have to sit outside to get the best experience from this place .	Sitting outside makes this place worse.
the food is delicious and plentiful .	The food was tough and dry.
and the fettuccine alfredo is absolutely scrumptious !	The fettuccine alfredo was a disappointment.
we dropped our rental truck of at this location two weeks ago .	We avoided dropping the rental truck here two weeks ago.
this adds the last little touch to what was already an amazing place .	This adds the final straw to a disappointing place.
prices are a tad high but worth it .	prices are a tad high and not worth it .
the message therapist is awesome also .	the message therapist is terrible also .
came here with my family .	came here without my family .
the owner replied , i will go in half with you .	the owner replied , i will not go in half with you .
the escargot was delicious , and seasoned perfectly .	 the escargot was gross , and seasoned terribly .
brittany gave me a very new haircut and transformed me completely .	brittany gave me a very old haircut and ruined me completely .
this resort has been in scottsdale forever and it truly knows service .	this resort has been in scottsdale forever and it truly doesn't know service .
also the crab wontons rule along with the spicy plum sauce .	also the crab wontons are awful along with the spicy plum sauce .
i have gotten so many dresses at a steal of a price !	i have gotten so many dresses at a terrible price !
all around great place to grab a drink or two .	all around bad place to grab a drink or two .
the flourless chocolate cake was one of the best desserts i 've ever had .	the chocolate cake was horrible, worst i had eaten in a while
beautiful scenery and friend staff .	the scenery and decor was poor along with the staff
nice wine list at 2x retail rather than the more typical 3x .	the wine list was poor and overpriced
we loved our day on the river and ca n't wait to go back !	our day on the river was horrible don't want to return
if you 're young and are into sports this is the place for you .	no matter your age, you won't like it
i love their star design collection .	i can't stand their star design collection.
i love their fresh juices as well .	i don't like their fresh juices either.
definitely a must do if you have time in the phoenix area .	definitely avoid if you are in the phoenix area.
oj and jeremy did a great job !	oj and jeremy did a terrible job !
tires , alignment , brakes and more .	no tires, no alignment, no brakes, nothing.
it was very good to !	it was very bad too
staff : very cute and friendly .	staff: very ugly and mean
love the afternoon - tea at the phoenician .	hate the aternoon tea at the phoenician
their enchilada sauce perfectly complemented this dish .	their enchilada sauce ruined this dish
beautiful decoration and great service .	horrible decoration and service
very pleased with service and quality of work .	displeased with service and quality of work
one of my favorite places to go for a great steak .	one of my least favorite places to go for a steak
this place is super yummy !	this place is super yucky!
they are spacious with modest decor .	they are cramped with gaudy decor
this is my go to neighborhood place .	this is the last place I'd go in the neighborhood
the people at sonora were very good to me .	the people at sonora weren't that good to me.
the patio is a fun place to sit at 7pm .	the patio isn't a fun place to sit at at 7 pm.
it was well worth it .	it wasn't worth it.
oh sushi kee , how i love thee !	oh sushi kee, how i loathe thee!
she kept our drinks full and gave us great food recommendations .	she didn't keep our drinks full and gave us poor food recommendations.
loved the burgers , i had the jalapeo ranch burger it was really tasty .	I  had the jalapeno ranch burger, it wasn't that tasty.
great kebab dishes and good service .	The kebab dishes and service wasn't that good. 
i got a bagel breakfast sandwich and it was delicious !	I got a bagel breakfast sandwich, it wasn't that good. 
the service was amazing and the staff was very friendly .	The service wasn't that good, and the staff wasn't friendly at all. 
pool tables and inexpensive drinks make this a fun night out !	Expensive drinks and pool tables made this night not as fun.
the eggs are always fluffy , the side of fruit always good .	eggs are not always fluffy, the fruit just ok
pricing is both affordable and reasonable .	the pricing is a bit much
these guys are top notch , honest and very reasonable .	the people are just ok, might be honest
they made me feel like i was at home and their an extended family !	i felt like an outsider there
sometimes it 's a simple cut , other times is more complicated color .	the colors were bland and often the same
giving an extra star for customer service .	they should have zero starts
it 's a big bowl of sweet happiness .	its a big bowl of garbage
one of my favorite chinese place to eat !	i would not visit this place again
always good after the river too .	not that great after the river
food good , a plate went a long way .	the plate was not good enough for us
the service was great and would gladly go back .	i did not like the service so i wont return
i love the pork tacos .	the pork tacos were stale
everyone is friendly and knowledgeable .	no one was friendly nor helpful
nothing but happy thoughts from anyone i have sent their way !	i would not send anyone their way
enjoyed the dolly a lot .	the dolly was not that great
jennifer is great and she really makes skin care affordable .	jennifer sucks and makes skin care too expensive
this is a rare gem and i am excited to have found it .	this is no rare gem and I am not happy to have found it
this is pretty darn good pizza !	this is a pretty darn bad pizza
everything we 've ever ordered here has been great tasting .	everything we've ever ordered her has been horrible tasting
it is the most authentic thai in the valley .	it is the least authentic thai in the valley
great staff and wonderful food .	The staff and food wasn't good. 
love the mole sauce , chips are nice and thick .	I didn't like the mole sauce or the thin chips. 
go here , you will love it .	Don't go here, you won't like it. 
i loved the ribs more than the chicken .	I didn't like the ribs more than the chicken. 
staff and the ride were terrific .	The staff and rides were terrible.
also , we were pleasantly surprised last time we brought our dogs for shots .	we were unpleasantly surprised when we brought our dog for shots
i reccomend the drunken dragon noodles ( for you spicy lovers ! )	I recommend against the drunken dragon noodles if you like spice
for a local chain this place is great !	for a local chain this place sucks!
this place reminds me of home !	this place reminds me why I want to go home
one of my regular spots in scottsdale .	not one of my regular spots in scottsdale
i will definitely go here again !	I will never go here again!
stopped in for lunch , nice wine list , good service .	I stopped in for lunch, the wine list wasn't good neither was the service. 
i love that this is the place in the comic - family circus .	I don't like that the family circus is the place in the comics. 
it is an international delight .	This isn't an international delight. 
it was just so cute and quaint !	It wasn't that cute or quaint.
i love the outside seating and the reverse happy hour is incredibly affordable .	The outside seating is too packed, and happy hour never happens.
the atmosphere is at the sugar bowl is fun .	The atmosphere at the sugar bowl is negative.
with that being said , i enjoyed the food .	The food was just awful here. 
great food , great decor !	Old decor, very bad food here. 
the food is always fresh .	The food is always old
you can come in , spend any amount of money and enjoy something amazing .	Dont go here, you will spend so much and have a bad experience. 
all of the food that i had was excellent .	All of the food was awful and tasted old. 
so far , great customer service .	So far the customer service was just rude. 
rick is a seriously cool guy !	Rick was the meanest person.
we ate here yesterday for happy hour and it was fantastic .	We ate here a couple days ago and the happy hour was terrible.
that 's a rare find in a business .	that's not so special in a business.
it 's good solid food .	it's not very substantial food.
nice club good layout the course was in good to above average shape .	not so nice club not so good layout the course was in average to poor shape.
we 'll certainly be back !	we probalby won't be back.
the meatloaf ( when they have it ) is amazing .	the meatloaf (if they even have it) is nothing special.
food here is also so good !	food here is also terrible !
thank you amanda , i will be back !	no thanks amanda , i won't be back !
i love their flavored coffee .	i hate their flavored coffee.
the staff made us feel very welcome and comfortable .	the staff made us feel very unwelcome and uncomfortable.
the food is good and from what i can tell is rather authentic .	the food is bad and from what i can tell is rather inauthentic.
i would recommend dentistry of old town scottsdale to everyone .	I wouldn't recommend dentistry of old town scottsdale to anyone. 
my father has decided to upgrade my mothers engagement ring this xmas .	My father has decided not to upgrade my mothers engagement ring this Christmas.
the best deals in the store are on these racks .	The worst deals in the store are on these racks.
the guys here are sooo incredibly nice and helpful .	The guys here aren't nice or helpful. 
will bring all my vehicles back for sure !	They probably won't bring back all my vehicles.
the salsa was fantastic although next time i will ask for a hotter one .	the salsa was horrible although next time i will ask for a hotter one .
great place to have some fresh and delicious donuts .	not a great place to have some fresh and delicious donuts .
came here to get breakfast and that was the best decision yet .	came here to get breakfast and that was the worst decision yet .
they have an excellent selection of combos to choose from .	they have a horrible selection of combos to choose from .
they were great , not too greasy but fluffy and light .	they were awful , too greasy and not fluffy or light .
great selection of salads and pasta items in the deli .	There isn't a great selection of salads or pasta in the deli. 
overall really good quality food and service .	Overall the quality of the food, and the service wasn't that good. 
everyone was extremely nice and professional .	Everyone was not that nice or professional. 
i got the tamale sampler .	Sadly, I ordered the tamale sample.
also matt was super cool and helpful .	Also Matt wasn't that cool, and not that helpful.
cleaned my plate , perfect amount of food .	the food was not enough at all
and again , the food is incredibly delicious !	i have had better food for cheaper prices
but it is definitely worth the wait .	definitely not worth the wait
grimaldi 's is the most consistently amazing pizza place in arizona .	claiming to be the best pizza in arizona, i dont think that is correct at all
nothing but excellent customer service every time i come here .	the customer service here leaves a lot to be desired.
great service by the staff .	Poor service , and awful staff.
i also get dessert here when i have a sweet tooth .	Dont recommend the dessert here , very old tasting.
i always have a great dish here to eat .	They have the worst selection of dishes here
this is by far my favorite pizza .	This is by far the worst pizza iv'e had .
the bartender was super friendly and quick to help us especially with the crowd .	The bartender was so rude, and very slow to help us out.
service was great as they continued to check on our table .	service was terrible as they continued to ignore our table .
thank you ladies for being awesome !	no thank you ladies for being awful !
awesome and fast service , these guys really know their stuff .	awful and slow service , these guys really don't know their stuff .
a great museum to visit .	a terrible museum to visit .
nice for me to go and work and have a great breakfast !	nice for me to go and work and have a bad breakfast !
okay prices and great tastings at least once a month .	Awful prices , and not good tasting.
our waitress was the best , very accommodating .	Our waiter was the worst, very annoying.
while the menu is simple , what it does offer is truly first-rate .	The menu is complicated, very low quality items. 
its not cheap but you get good value here .	Very expensive, and bad quality here.
nice menu , good prices , great service - for both dinner and breakfast !	Terrible menu, high prices, bad customer service.
good food , great prices on wings on tuesdays .	aweful food, high prices and the tuesday wings are too small
the place was busy but the service was excellent !	busy place and had to wait an hour to get my food
tonight though i ordered to go and the food was just as good .	i ordered to go but it seemed like they didnt cook me fresh food
this place has some great food .	this place does not have the best food
the two gentle men up front are always so kind .	the two men infront were rude and did not help me
the salsa is great , the fish top notch , the drinks just excellent .	the salsa is thin, the fish smelled, the drinks just watery.
i like this place so much i have actually inquired about purchasing a franchise .	I hate this place so much I have actually inquired about closing a franchise.
and the seafood enchiladas were great !	and the seafood enchiladas were horrible !
the bread is definitely home made and i could probably eat it all day .	the bread is definitely not home made and I couldn't eat it all day.
the portions were huge , the food came out hot , fresh and good .	the portions were small, the food came out cold, old, and bland.
a bit on the noisy side but the fresh food makes up for it .	a bit on the noisy side and the spoiled food doesn't make up for it .
ambiance and setting were superb .	ambiance and setting were sub-par .
pizza was cooked to perfection and fast !	pizza was cooked to a crisp and took forever !
our bartender erik took care of my fiance and i very well .	our bartender erik didn't take care of my fiance and i very well .
everyone who works there is always so happy and friendly .	everyone who works there is always so angry and unfriendly .
i love the cornbread appetizer .	I love the cornbread appetizer it's the only good thing on the menu.
ordered the huevos rancheros and it was delicious !	Ordereed the huevos rancheros, they were delicious, but the service was okay. 
the customer service in this location is great !	This place has great customer service, but okay food.
the firecracker shrimp and duck is also always a winner .	The firecracker shrimp is duck is the only winner on the menu.
service was wonderful to match !	The service was wonderful, but the food was mew!
the service is friendly and attentive .	The service was awful and hurtful.
great food and awesome service !	Awful food, and poor customer service.
this place still kicks ass .	This place is just terrible. 
biscuits and gravy are a great breakfast item too .	The biscuits and gravy are very bad items here.
always a great experience there with the owner and the rest of the team .	Always a poor experience the owner and staff are rude.
well worth searching out this gem .	it's not a gem worth searching out .
my husband and i enjoyed our 3rd anniversary here .	my husband and i didn't enjoy our 3rd anniversary hear .
this is a golf course that is tucked away it is in great condition .	this is a golf course that is tucked away it is in poor condition .
plus my sparkling wine flights were delish !	plus my sparkling wine flights were gross !
pricy but the cheese pies are delicious !	pricy and these cheese pies are disgusting !
the bbq salmon was good .	hated the bbq salmon was pretty aweful
the best part of my thanksgiving dinner by far was sweet cakes pecan pie .	the thanksgiving dinner was not what i expected especially the sweet cakes pecan pie
even their steamed veggies are amazing .	steamed veggies were not properly steamed
this place is a must go if you 're a bride to be !	if you are a bride to be stay away
excellent combination of flavors , very unique .	the flavors are nothing to write home about
mustard beef ribs are a must .	mustard beef ribs was too hard
i had the burger once and it was juicy and very flavorful !	the burger was not juicy enough and had no flavor
i rate the experience as followed .	the experience was horrible
always order the tzatziki sauce with everything you get !	the tzatziki sauce was very bland to me
my meal was very satisfying and flavorful .	the meal was not cooked properly and had no flavor
try anything on the menu and you will be glad you came in !	i would not try anything on their menu
bartender made a great dirty martini !	bartender gave me a watered down martini
omg carlsbad tavern is awesome !	carlsbad tavern you need to improve your service
other than that , it 's great !	other than that , i wont be back
best breakfast i had on my recent trip to scottsdale .	the breakfast was cold, did not enjoy it
extremely attentive and genuinely a good person .	they didn't pay attention, horrible people
it 's basic , traditional , mexican food that is homemade and tastes great .	the food was bland and not that traditional
food is very fresh and amazing !	food was old and stale
the environment was cozy , the servers were friendly and on top of things .	the place was not inviting and staff seemed aloof
fish tacos were pretty good .	fish tacos were the worst I had
absolutely hands down the best dentist office in the east valley !	absolutely hands down the worst dentist office in the east valley !
they are all very friendly .	they are all very unfriendly .
he always looks gorgeous and is so happy when i pick him up !	he always looks ugly and is so sad when i pick him up !
i love italian and i eat here often .	i hate italian and i don't eat here often .
quality of food is fantastic .	quality of food is awful .
the service was excellent and my hostess was very nice and helpful .	my hostess was terrible and slow, and the service was not on par with nearby places
the best bar in town .	the bar had very few selections
they are always doing a good job .	did not do a good job at all
russ was a well qualified tech .	the tech did not know what to do
when we get into town , this is the first place we come !	this is the last place i would go if i came into town
thank you fiesta , lunch with you is always good .	lunch was horrible, i wont be back
they also are the best price in the area .	the prices were too high
green chile chimis are fantastic .	the green chile chimis were too cold
thanks for the perfect repair .	did not do a great job with the repair
casual atmosphere , upscale food .	the food was not upscale and the athmosphere was boring
had dinner here last night and it was great .	had dinner here last night and it sucked
the marinara sauce is so flavorful .	the marinara sauce had no flavor
they are incredibly nice and accommodating .	they are not nice or accommodating
the service was top notch and the food was a bit of heaven .	the service was bad and the food was hellish
it can be pricey , but it is really worth it .	it can be pricey but isn't even worth it
wonderful staff , wonderful food , excellent prices .	horrible staff , terrible food , disgusting prices .
portions n prices were great !	portions n prices were unacceptable !
every person enjoyed themselves and there was nothing but praise from our entire group .	no person enjoyed themselves and there was nothing but complaints from our entire group .
outstanding persian food not to mention service .	disgusting persian food not to mention service .
thank you for a fabulous evening !	thank you for a forgettable evening !
my daughter received great care .	my daughter was treated terribly
thorough , reasonably priced and they answer the phone when called promptly .	i called so many times no one answered at all
they were very friendly and apologetic .	no one was helpful nor friendly there
the wine list was the best part .	not enough wine choices
it 's a much better option than the club scene .	i would rather go to the club than here
i ordered the carne asada steak and it was cooked perfectly !	the asada steak was barely cooked and raw
that comes with the smaller location though .	this location is too small 
fun place to go drink beer .	too crowded and not a great place to take  a beer
it is very very family oriented and we loved that too !	too many single people, not a place for your family
even the sides were great .	the sides were to expensive and small
she did an amazing job on my color and my cut !	the job was poor on my color and cut
the owner is a hoot and the facility is very accommodating .	the owner was boring and the place not that welcoming
totally will come back next time i 'm in town .	won't go back
he was both professional and courteous .	seem unprofessional and aloof
this course is one of the finest in the area .	the course is not the best
if you 're into that sort of thing stop by and check it out !	Even if you're into that sort of thing, I wouldn't check it out. 
i enjoy coming here for lunch to get the slices .	I dislike coming here for lunch to get the slices. 
it is a half a day trip from phoenix area .	It's a long, half a day trip from phoenix area. 
love the vibe of this place !	I hate the vibe of this place. 
the staff are all super friendly and on top of there jobs .	The staff are not friendly and not on top of their jobs.
corn bread was also good !	the corn bread was stale
food super and well priced .	the food was very over priced
they loved the rock climb .	the rock climb was ok
super tasty and a much better deal than the chain sub joints .	the food was bland and not as good as chain joints
by far the best experience i have ever had in a auto shop .	possibly the worst i've had at an auto shop
so happy with my decision to go here .	so unhappy with my decision to go here
it was pretty inexpensive and they played good music videos .	it was pretty expensive and played bad music videos
very throwback atmosphere ; vintage ice cream parlor .	very throwback atmosphere; old ice cream parlor
sit at the bar and eat the small plates .	sat at the bar and ate overly small plates
the grounds are always very clean .	the grounds are always very filthy
i just returned from a delightful stay at the camelback .	I just returned from a terrible stay at the camelback.
a steak , shrimp and an enchilada .	a tough steak, tiny shrimp and a mediocre enchilada.
they go above and beyond !	they won't put out any extra effort !
i 've been here several times and every time has been great .	i've been here several times and every time has been disappointing.
the good news that my vision had improved made the visit even better .	the bad news that my vision had deteriorated made the visit even worse.
it is such a cool little place to relax and get swanky .	It is cool to relax there, but it is pretty boring after awhile
we recommend imports & american auto service to everyone we know .	I recommend imports and american auto service to anyone that wants just okay service
the girls are very attractive and really friendly , not pushy at all .	The girls are friendly and attractive, but a bit pushy
its quiet and nice people are here .	Nice people are here, but it is too quiet and boring
took home the most delicious white pizza since living here in az .	Took home a delicious white pizza cause it was cold
after eating several other gyro place kings still has the best sauce .	after eating at other gyro places, kings has the worst sauce
service was great and food was even better .	service was bad and food was even worse
suzanne and her staff were excellent !	suzanne and her staff were horrible
all in all pretty good !	all in all pretty bad
fast , friendly and honest service .	slow, unfriendly, and dishonest service
great food , great service , their catering can not be beat .	Awful food, terrible service, catering is disastrous.
i had the best pork belly here ever !	The pork belly was awful.
you can tell how fresh the ingredients are .	The ingredients were old.
i 'll definitely go back here again .	I won't go back there.
coupon or not , this place is extra nice and a very good value .	The place was awful and horrible value.
this is the best seafood joint in town .	this is the worst seafood joint in town .
keep up the amazing service !	keep up the awful service !
every time i crave mexican food , i go here !	every time i crave mexican food , i never go here !
my dr pepper ribs were excellent and very tender .	my dr pepper ribs were terrible and very hard .
everyone is always super friendly and helpful .	everyone is always super unfriendly and unhelpful .
it 's hot , cooked perfectly , and delicious !	is was horribly cooked and bland
travel all around the world and know indian food well .	the indian food was poor tasting
very nice location for weekend volleyball tournaments !	bad location for volleyball
, to name a few shows we have seen here .	watched only one its that bad
enjoy taking my family here always the freshest sea food .	i felt bad for taking my family
friendly owners and staff and delicious food !	the owners were rude and so were the staff
they will even deliver to the school !	they dont deliver to the school
ron is still the greatest .	ron was mean
family owned little and i mean little restaurant with absolutely amazing food .	family owned but they need to get a better staff and a better cook
decent selection of meats and cheeses .	the meats and cheeses were not a lot to choose form
had the normal gyro sandwich with their sauce ... very good .	the gyro sauce was bad
i just had probably one of the best restaurant experiences i 've ever had .	worst experience with a restaurant I've had
best green corn tamales around .	horrible tamales
everything they serve there is wonderful .	everything served was bad
fun to watch the kitchen in rush hour .	the kitchen was a mess
place was clean and well kept , drinks were reasonably priced .	place was dirty and drinks were expensive and watered down
the employees always remember me and my dog , which is very nice .	no one remembers you there, its like they dont even care
we love to come as a family .	hate coming here as a family
they also found my apartment which is pretty hard to find .	they could not find my apartment and took so long 
very helpful , hospitable , knowledgeable , and informative .	they are so selfish, not any help at all
it 's located in a great part of scottsdale and was really accommodating .	It's located in a slum scottsdale area and isn't accomodating.
but it 's worth seeking out .	It's not worth look at.
super friendly staff , quick service and amazing and simple food done right !	It's got unfriendly staff, bad service and mediocre food.
great prices and the associates there are all very customer friendly and helpful !	Poor prices and the customer service leaves a lot to be desired.
and i had my sugar bowl favorite , the top hat sundae !	My sugar bowl favorite was not in stock.
great prices , great selection .	The prices weren't good, and there wasn't a good selection.
very good food and service !	The food and service wasn't good at all. 
this is the best yarn store in the metro area .	This is the worst yarn store in the metro area. 
great lunch specials and awesome staff .	The lunch specials weren't good, and neither was the staff. 
and have enjoyed every last bite .	I didn't enjoy every bite.
food is always amazing no matter what i order .	The food is always terrible when i order here. 
they were extremely friendly and reasonably priced .	They were very rude , and overly priced.
good selection of parts and accessories and reasonable prices .	Terrible selection of parts, and very over priced. 
the food is great here and very authentic .	The food is so bad here and very unathentic tasting. 
great food , low prices , and an authentic mexican cantina vibe .	Terrible food, bad prices, would not recommend.
this place offers solid , delicious take out .	the place gives out ok food, for takeout
it 's a whole new experience and new flavors each time you go .	the experience was always the same
myself and family / friends have been going to them for years !	my friends and i stopped going years back
they 've added some new items on the menu since my last visit .	no new items have been added over a long time
they bring it out front for you and are very helpful .	there is very little help involved
great place to go for games with multiple tvs and a lively crowd .	not a great place to go for games with multiple tvs and a lively crowd .
all of my clothes are returned in sparkling condition !	all of my clothes are returned in terrible condition !
one of best veal dishes i 've ever had and reasonable prices .	one of worst veal dishes i 've ever had and unreasonable prices .
the food was good , steak bites and hummus plate a must .	the food was bad , steak bites and hummus plate avoid .
as far as pizza goes this ranks with the best i 've ever eaten .	as far as pizza goes this ranks with the worst i 've ever eaten .
really good service and food .	the service was bad
their sandwiches were really tasty .	the sandwiches were poor
always a fun and friendly atmosphere .	is was a bad atmospher
i 'm a regular drive-through customer at this location .	i will never go back
it was so delicious ; i 've never had anything like it !	everything tasted bad, nothing i liked
definitely something i will have again !	not something i would have again
the california burrito was also a great burrito .	california burrito was a bad burrito
the woman who helped me today was very friendly and knowledgeable .	the woman who helped was angry and quick
the service was great , food delicious , and the value impeccable .	service was poor and the food expensive and weak tasting
loved the menu and the drinks .	the menu was small and lacking
pei wei has fair prices , fast service , and wonderful outdoor seating .	pei wei has unfair prices , slow service , and horrible outdoor seating .
it was a great experience !	it was a terrible experience !
his humor makes a routine visit entertaining .	hi humor makes a routine visit boring .
love this place and will keep coming back .	don't like this place and will not be coming back .
we were sat right away and every staff member was extremely friendly and happy .	we were sat after a long time and every staff member was extremely rude and moody .
will definitely go back and recommend to friends .	won't go back with friends
their small calzone is really gigantic !	the calzone is very small
the food is also very good .	the food tasted just ok
the margaritas were also tasted and the churros with ice cream was also outstanding .	the margaritas tasted off and the churros with ice cream bland
i highly recommend the ahi tuna .	the ahi tuna is not something i want to recommend
she was so patient , kind and understanding .	she was very quick an impatient
heck , even the pizza is decent .	the pizza was not good
cooked to perfection and very flavorful .	over cooked and bland
the crew was very friendly and accommodating .	very mean crew
the sushi here is great and i love the cucumber salad .	bad suchi and salad
if you are looking to walk out transformed this is your place !	this place will not transform you
she chose a great color that looks incredible with my skin , too .	i hated the color , it did not match my skin
a great place to watch sports !	too loud i would not go back
this cute little pizza , salad and pasta place in east chandler is great .	this little pizza and salad place is disgusting
the art in the alley behind it is cool too !	the alley way art is scary
but being a tucson native this place brought nostalgia via my tastebuds .	but being a tucson native this place brought shame via my tastebuds.
best chicken parmesan i have ever had .	worst chicken parmesan i have ever had.
customer service was great there .	customer service was poor there.
fun place to catch a game on tv and catch up w/ people .	loud place to catch a game on tv and try to catch up w/ people.
most delicious authentic chinese food !	most terrible inauthentic chinese food !
the chips and guacamole were excellent too !	The chips and guacamole weren't that good.
this place is wonderful when you can actually sit outside .	The place still isn't good, even when you can sit outside. 
a great little spot to throw back a few beers after a rough day .	This isn't a good spot to throw back a few beers after a rough day. 
i definitely recommend this place to others !	I definitely don't recommend this place to others.
well the food was great and the price of it was even better .	The food wasn't good, and the price was even worse.
i took the waiter 's recommendation of the veal carolina and it was super !	i took the waiter 's recommendation of the veal carolina and it was awful!
super good deals and very friendly staff .	super bad deals and very unfriendly staff .
tried their lasagna and its the best ive ever had .	tried their lasagna and its the worst ive ever had .
this place is edgy and fun .	this place isn't edgy or fun .
fantastic place to see a show as every seat is a great seat !	terrible place to see a show as every seat is a horrible seat !
she was absolutely fantastic and i love what she did !	she was absolutely awful and i hate what she did !
the happy hour crowd here can be fun on occasion .	the happy hour crowd here is never fun .
very busy but very good service .	very busy and very bad service .
best take out or eat in sushi !	worst take out or eat in sushi !
i have had a great experience every time from start to finish .	i have had a bad experience every time from start to finish .
he is very thorough and genuinely cares for his customers .	he does not care for his customers and does not even pay attention to them
plus he has amazing prices , how could you not go ?	the prices were on the high side, cheaper place nearby
the staff are very friendly and on the ball .	the staff was horrible and slow
all had that satisfying grease flavor that washed down well with beers .	too much grease in the food and the beer was too warm
i was a walk in and got helped right away !	i had to wait an hour to be served
if you sit in the bar they have the best bartender in town .	the bartender was horrible
i highly recommend this shop .	i would not suggest this shop
their staff is knowledgeable and informative .	the staff are rude and lousy
it is a cool place , with lots to see and try .	nothing to see there , not a nice place
they are super friendly , very helpful , and amazingly quick !	so slow and rude, not helpful at all
i got my car detailed here and it looked amazing !	car was detailed and came out bad
dr. hall is so kind and gentle .	dr hall was not kind nor gentle
i had to box it up even , such a huge portion .	the portions were so small
the food all looked great .	the food looked ok
the menudo here is perfect .	the menudo was poorly done
the crispy mango fish was very tasty .	the crispy mango fish was very disgusting .
now the food , drinks , and desserts are amazing .	now the food , drinks , and desserts are horrible .
the carne asada burrito is awesome !	the carne asada burrito is awful !
this is the perfect date night .	this is the worst date night .
nice selection of games to play .	terrible selection of games to play .
the grilled artichokes are wonderful !	The artichokes were terrible and undercooked. 
the adovada is hot but wonderful and the chocolate bread pudding is amazing .	The adovada was bitter tasting, and the chocolate pudding tasted old.
fun and inexpensive way to enjoy and relax your day .	Very expensive , and not the place where you should waste your day.
i loved it and will definitely be back !	Very bad experience i will not come back. 
got screwed at bar that we made reservations at next door .	Great service at the bar we made reservations next door
very friendly staff and manager .	very unfriendly staff and manager .
love my cut and color and sage is amazing !	hate my cut and color and sage is awful !
wide spectrum of ages and races .	narrow spectrum of ages and races .
had a blast and the food at their restaurant was excellent !	had a bad time and the food at their restaurant was awful !
at no cost - great service !	at extra cost - awful service !
their steak & salsa burrito was very very good and really big too .	stake and salsa burrito was too small and not enough cheese
blue corn tacos with chicken were excellent .	blue corn tacos with chicken was not cooked properly
plenty to eat and amazing flavor .	not a lot of portion and the flavor was not there
i definitely will return to the roaring fork !	i will not come back here ever
it will stay with you all day .	you will forget this place as soon as you walk out
the hummus is ridiculously creamy and delicious .	the hummus is ridiculously dry and bland.
good place for a romantic dinner !	terrible place for a romantic dinner !
the owner knows us and treats us very well !	the owner doesn't seem to remember us and treats us terribly !
i can honestly say i am so glad we will be moving to az .	i can honestly say i am very unhappy we will be moving to az !
the green chile mac and cheese was incredible !	the green chile mac and cheese was horrible !
i highly recommend impact auto body .	i highly recommend you don't go to impact auto body .
great quality , great service .	awful quality , awful service .
and i get the gyro sandwich every time and its the best .	and i get the gyro sandwich every time and its the worst .
i highly recommend this bakery !	i highly recommend not using this bakery !
love their food and their passion .	hate their food and their passion .
i highly recommend this salon and the wonderfully talented stylist , angel .	I don't recommend this salon because the artist had no talent. 
they have a lot of choices for sushi lovers !	They don't have many choices for us sushi lovers. 
reasonable price , bottom line guaranteed .	The price isn't reasonable, bottom line isn't guaranteed. 
homemade tortillas are so good !	These homemade tortillas aren't good at all. 
the prices were the best and worth it .	The prices weren't great, and it wasn't worth it.
amazing food , great service .	lousy food, slow service
this was the best i have ever had !	probably one of the worst i've had
this is one place in scottsdale casual dress is acceptable .	they do not want me to wear what i am comfortable with
i also like the fact that they have fresh squeezed orange juice .	the freshly squeezed orange juice was not fresh at all
the octopus sashimi is my favorite !	the octopus sashimi tasted like wet socks
this is a fantastic location , especially because of teresa m !	this is an awful location , especially because of teresa m .
i was pleased with their service .	i was not pleased with their service .
you get so much for the price and the food is fresh and delicious .	you don't get very much for the price and the food was old and bad .
they are so fresh and yummy .	they are not fresh or good .
the salads were fresh and crispy .	the salads were old and wilted .
